###############
#o#.#.#.#.#.#o#
#.............#
##.#.#.#.#.#.##
#.............#
#.#.#.#.#.#.#.#
#......N......#
##.#.#.#.#.#.##
#.............#
#.#.#.#.#.#.#.#
#.............#
##o#.#.#.#.#o##
###############
