##########
#o......o#
########.#
#.o#o.o#.#
#.##.#...#
#.##.###.#
#.##..E#.#
#.######.#
#o...o..o#
##########
