###############
#o...........o#
#.............#
#.............#
#.............#
#.............#
#.............#
#.....E.......#
#.............#
#.............#
#.............#
#.............#
#o...........o#
###############
